Sheldon	Larson
Sophia	Maldonado
Miriam	Lynch
Roman	Delgado
Reginald	Figueroa
Aubrey	James
Sherri	French
Gilberto	Morrison
Wilfred	Kim
Louis	Russell
Melvin	Spencer
Kristin	Jordan
Olive	Miller
Marco	Garrett
Fredrick	Mcguire
Rafael	Jensen
Tanya	Fitzgerald
Wade	Harvey
Theodore Anderson
Hattie	Castillo
Darryl	Nelson
Jerry	Greer
Georgia	Schwartz
Jerome	Holloway
Mercedes	Mclaughlin
Lucas	Logan
Adrienne	Roy
Angel	Moreno
Madeline	Holt
Katrina	Becker
Jessie	Howard
Miguel	Olson
Derek	Rogers
Ana	Walker
Bradley	Scott
Geoffrey	Boyd
Nichole	Thornton
Wendell	Flowers
Troy	Taylor
Yvonne	Williamson
Esther	Walton
Christine	Estrada
Misty	Crawford
Bryant	Davis
Tomas	Osborne
Dwayne	Leonard
Jenny	Dixon
Terry	Chambers
Lynn	Moore
Crystal	Graves
Rodolfo	Munoz
Pete	Hines
Lorena	Allen
Donnie	Gill
Eugene	Tucker
Lindsay	Saunders
Melody	Brown
Fred	Hamilton
Carla	Brady
Sheri	Newton
Kristy	Massey
Edwin	Manning
Keith	Patrick
Mario	Sanchez
Abraham	Hunt
Tracy	Singleton
Annie	Peters
Connie	George
Camille	Cortez
Cameron	Clarke
Brandon	Garner
Cheryl	Allison
Genevieve Rodgers
Lela	Douglas
Janis	Rodriquez
Martin	Nguyen
Daryl	Cooper
Patty	Patton
Mark	Vasquez
Cody	Torres
Elsa	Hammond
Shaun	Meyer
Emmett	Norris
Jerald	Ramirez
William	Romero
Lynette	Jennings
Alfredo	Marshall
Angie	Owen
Sherry	Gonzales
Luther	Park
Hector	Reyes
Monique	Boone
Loretta	Cain
Christy	Joseph
Loren	Farmer
Megan	Yates
Patti	Lowe
Lola	Hill
Ray	Richardson
Erica	Nichols
